1 1 0 0 0 0 0 0 4 0 
0 1 1 7 0 0 0 0 1 0 
0 1 0 0 0 0 0 0 1 0 
0 1 2 1 1 1 1 0 1 0 
0 1 0 1 1 1 1 0 1 0 
0 1 0 5 10 1 1 0 1 0 
0 1 0 1 9 10 1 0 1 0 
0 1 0 0 0 0 0 0 1 0 
0 1 1 1 1 1 1 1 1 0 
0 0 0 0 0 0 0 0 0 0 