1 1 0 0 0 0 0 0 0 0 
0 1 7 0 8 14 1 11 9 0 
0 2 0 0 7 14 1 10 7 0 
0 1 0 0 0 0 3 0 0 0 
0 1 0 5 10 1 1 1 5 0 
0 10 0 6 10 1 1 5 8 0 
0 10 0 0 0 3 0 0 0 0 
0 8 1 1 1 1 1 1 1 0 
0 6 8 0 0 1 11 1 15 0 
0 0 0 0 0 0 4 0 0 0
1 1 0 0 0 0 0 0 0 0 
0 1 10 10 10 1 6 6 5 0 
0 0 0 0 0 1 0 0 0 0 
0 7 11 1 0 1 0 6 15 0 
0 7 11 1 3 1 2 1 5 0 
0 13 1 1 0 1 0 1 9 0 
0 0 2 0 0 0 0 0 3 0 
0 1 1 1 11 8 10 1 1 0 
0 1 1 1 1 10 1 1 1 0 
0 0 4 0 0 0 0 0 0 0 
1 1 0 0 0 0 0 0 0 0 
0 13 5 6 5 1 0 1 7 0 
0 1 1 1 1 1 0 1 7 0 
0 1 11 10 0 0 0 1 8 0 
0 15 11 10 2 1 1 13 13 0 
0 0 0 0 0 14 9 1 1 0 
0 6 13 1 0 0 0 2 0 0 
0 5 11 1 1 1 1 1 1 O 
0 1 11 1 1 1 1 1 1 0 
0 0 0 0 0 4 0 0 0 0 
1 1 0 0 0 0 0 0 0 0 
0 9 1 1 1 1 1 1 1 0 
0 0 0 0 0 0 0 0 1 0 
0 1 1 1 0 1 1 2 1 0 
0 1 1 1 0 1 1 0 1 0 
4 1 1 1 0 1 1 0 1 0 
0 1 1 1 3 1 1 0 1 0 
0 1 1 1 0 1 1 0 1 0 
0 1 1 1 0 1 1 0 15 0 
0 0 0 0 0 0 0 0 0 0  
1 1 0 0 0 0 0 0 0 0 
0 1 0 1 1 1 1 1 1 0 
0 1 0 1 1 1 1 1 1 0 
0 1 0 1 1 1 1 1 1 0 
0 1 0 1 15 16 1 1 1 0 
0 1 0 1 1 1 1 1 1 0 
0 1 0 1 1 1 1 1 1 0 
0 1 0 1 1 1 1 1 1 0 
0 1 3 1 1 1 1 1 1 0 
0 0 0 0 0 0 0 0 0 0 